#################@###############
#..........#......#.#...#.......#
#.#.#####.##.####...#.#.#.#####.#
#.#.#.#.#.....#.#.#.#.#.#.#...#.#
###.#.....#.#.#.#.###.#.###.#.#.#
#...#.#####...#.#.....#.....#.#.#
#####.....#####.#############.###
#...####.##...#...............#.#
#.###..########.########.######.#
#.#......#......#.#...#...#.....#
#######.##.####...#.#.#.#.#.###.#
#........#.#..#.#.#.#.#.#.......#
#.#####.##.##.#.###.#.#.######.##
#.#.........#.#.....#........#..#
###.####.####.##############.##.#
#...#..#.#.............#...#..#.#
########.#######.#########.##.#.#
#.............................#.#
###.###########################.#
#.#...................#...#.....#
#.#.#####.###.#######.#####.#.#.#
#.#.#.....#.#.#...............#.#
###.#.#.#.###.#.#########.#####.#
#...#...#.....#.#.....#.#..#....#
#.#############.#.###.###..#.####
#.#.#...#.....#.###........#.#..#
#.#.###.#.###.#.#.####.#####.#..#
#.#...#.#.....#...#..........####
#.###.#########.#.############..#
#...#.....#...#.#...............#
#.#.#####.........#############.#
#.......#.#...#........#........#
#########F#######################