####@############################
#..#.#.....######################
####.#.###.........####......#.##
#....#.#.##..#####....########.##
#.##...#.........####..........##
#.##.####.######.#############.##
#....#....#....#....#...........#
######.##############.###########
#....#.#............#......#....#
#.##.#.##############.####.#.####
#....#.......#..................#
#.####....##.#.##.#.#.#..###.####
#.#...###..#.#.##.#.#.#.##...#..#
#.#.#....#.#.#....#.#......#.##.#
#.#.#.##.#.#.####.###.######.##.#
#.....#..#.#.#..#......#...#....#
#####.##...###..###.########.####
#.....#..##..#...#..............#
###.#.#..##.###########.#######.#
#.#.###.....#.....#.###.........#
#.#.....###.#.#.###.....####..#.#
#.#.###...#.#.#.#.#####....#..#.#
#.###...#.###.#.......#..#...####
#.....#.#.....#.#####.#..#.#....#
#.#####.#######....#..#######.#.#
#.............#.#####.#.#...#...#
#.###########.#..#....#.##.######
#.............######............#
#..#.###########...#######.######
#..#.........#...#.........#....#
####...#######.###########.######
#....#...................#.#....#
##########################F######