###############@#################
#.......#...#.......#...........#
#.#####.#.#.#.#.###.###########.#
#.#...#...#...#.#...........#.#.#
###.#.#.#######.#.#########.#.#.#
#...#.#...#...#.#.#.#.......#.#.#
#.###.#.#.#.###.#.#.#.#######.#.#
#.#.#...#.#.....#...#.#.....#...#
#.#.#####.#####.#####.#.#######.#
#...#.#.......#...#.#...........#
#####.#.#########.#.###.#########
#...#.....#.....#.#.#.#.......#.#
#.#.#######.###.#.#.#.#######.#.#
#.#.......#...#...#...#.....#...#
#.#######.###.#####.#####.#.###.#
#.#.....#...#...#.#...#...#.....#
#.#.###.###.#.#.#.###.#.#.#######
#.....#.#.#...#.#...#...#.#.....#
#.###.#.#.#####.###.#####.#.###.#
#...#.#...#...#...#.........#...#
#####.#####.#####.###########.###
#.#...#.....#...#...#...........#
#.#.###.#.###.#####.#.#######.###
#.#...#.#.....#.....#.......#...#
#.###.#.###.###.#########.#.###.#
#...#.....#...#.....#...#.#...#.#
###.#.###.#########.###.#.###.#.#
#.....#...#...#...#...#...#...#.#
#######.###.#.#.#.###.#########.#
#.....#.#...#...#...#.........#.#
#.#####.#.#########.#.#######.#.#
#.......#.........#...#.......#.#
#################F###############